border_size=1
usage=map

Ww          , Ww          , Ww          , Ww          , Ww          
Ww          , Ww          , Gg          , Ww          , Ww          
Ww          , Gg          , Gg          , Gg          , Ww          
Ww          , Gg          , Gg          , Gg          , Ww          
Ww          , Ww          , Ww          , Ww          , Ww          
Ww          , Ww          , Gd          , Ww          , Ww          
Ww          , Gd          , Gd          , Gd          , Ww          
Ww          , Gd          , Gd          , Gd          , Ww          
Ww          , Ww          , Ww          , Ww          , Ww          
Ww          , Ww          , Rb          , Ww          , Ww          
Ww          , Rb          , Rb          , Rb          , Ww          
Ww          , Rb          , Rb          , Rb          , Ww          
Ww          , Ww          , Ww          , Ww          , Ww          
Ww          , Ww          , Rd          , Ww          , Ww          
Ww          , Rd          , Rd          , Rd          , Ww          
Ww          , Rd          , Rd          , Rd          , Ww          
Ww          , Ww          , Ww          , Ww          , Ww          
Ww          , Ww          , Ai          , Ww          , Ww          
Ww          , Ai          , Ai          , Ai          , Ww          
Ww          , Ai          , Ai          , Ai          , Ww          
Ww          , Ww          , Ww          , Ww          , Ww          
Ww          , Ww          , Aa          , Ww          , Ww          
Ww          , Aa          , Aa          , Aa          , Ww          
Ww          , Aa          , Aa          , Aa          , Ww          
Ww          , Ww          , Ww          , Ww          , Ww          
Ww          , Ww          , Dd          , Ww          , Ww          
Ww          , Dd          , Dd          , Dd          , Ww          
Ww          , Dd          , Dd          , Dd          , Ww          
Ww          , Ww          , Ww          , Ww          , Ww          
